#########
#.B.#W#.#
#BB..W..#
#....W.F#
#....W..#
#...#W#.#
#########
